##################
..................
.......####.......
..................
........##........
##################