##.######
#...#...#
#.#.#...#
#...#...#
#...#...#
#.#######
\robot 1 0
\robot 1 1
\robot 2 1